111111111
100000001
1PC0C00E1
100000001
111111111