
111111111111111111111111111111111111111111111
100010000000000000000000111000000000000000001
10C10000000C010000P000C0010000000000100000001
1010X00000001011000000111000C000000001000C001
1001110C0000000011101100010000X00011100000001
10000111110000010000C000001011110000000000001
1000X0000010001000000000X00000001100000X00001
100C0000010110000000000000000C00000100C100001
100000001000010000000000000000001110000010001
1000C001000000100000C000000000000100000001111
10100010000C000000100100000000001100000C00001
100101000X00000000010000000000010100000000001
100110100100000000011000000000100010000000001
10000000001000000X000111100001000001000X01111
10010C00001100000000C0011111100000000C0010001
111000000001000000000001000000000000000100X01
10010000C0000100C000100000000C0001100100E0X01
1000000100000010000000000000000000000100X0001
111111111111111111111111111111111111111111111



