111111111111111111111111111111111111111
100C100C100C100C100C100C100C100C100C101
1E100C100C100C100C100C100C100C100C100C1
10000000000000000000000X000000000000001
100C100C100C100C100C100C100C100C100C101
1C100C100C100C100C100C100C100C100C100C1
100000000000000000000000000000000000011
100C100C100C100C100C100C100C100C100C101
1C100C100C100C100C100C100C100C1X0C100C1
100000000000000000000000000000000000001
100C100C100C100C100C100C100C100C100C101
1C100C100C100C100C100C100C100C100C100C1
10000000000E000000000000000000000000011
100C100C100C100C100C100C100C100C100C101
1C100C100C100C100C100C100C100C100C100C1
11000X000000000000000000000000000000101
100C100C100C100C100C100C100C100C100C101
1C100C100C10PC100C100C100C100C100C100C1
111111111111111111111111111111111111111